++++++++++++
+  AA      +
+  A0A     +
+   A    AA+ 
+        Aa+
++++++++++++
