+++++++++++
+A0Aa     +
+ + + + + +
+ +a+ + + +
+ + + + + +
+ + + + + +
+ + + + + +
+ + + + + +
+         +
+++++++++++