++++++++++++++++++++++++
+           g +        +
+  ++++   ++++    ++++ +
+   h +           + f  +
+++++++           ++++++
++++       ABC         +
++e++      D0E     ++d++
+          FGH      ++++
++++++            ++++++
+  c +            +  a +
+ ++++    ++++   ++++  +
+         + b          +
++++++++++++++++++++++++