+++++++++++++++
+0A          a+
+             +
+             +
+             +
+             +
+             +
+             +
+             +
+             +
+             +
+             +
+             +   
+             +
+++++++++++++++
