++++++++++++++++++++++++++++++
+0A                         a+
+ A                         a+
+ A                         a+
+ A                         a+
+ A                         a+
+ A                         a+
+ A                         a+
+ A                         a+
+ A                         a+
+ A                         a+
+ A                         a+
+ A                         a+
+ A                         a+
+ A                         a+
+ A                         a+
+ A                         a+
+ A                         a+
+ A                         a+
+ A                         a+
+ A                         a+
+ A                         a+
+ A                         a+
+ A                         a+
+ A                         a+   
+ A                         a+
+ A                         a+
+ A                         a+
+ A                         a+
++++++++++++++++++++++++++++++
