++++++++++++++++++++++++++++++++++++++++++++++++++++++++++++
+0A                                                       a+
+                                                          +
+                                                          +
+                                                          +
+                                                          +
+                                                          +
+                                                          +
+                                                          +
+                                                          +
+                                                          +
+                                                          +
+                                                          +
+                                                          +
+                                                          +
+                                                          +
+                                                          +
+                                                          +
+                                                          +
+                                                          +
+                                                          +
+                                                          +
+                                                          +
+                                                          +
+                                                          +
+                                                          +
+                                                          +
+                                                          +
+                                                          +
+                                                          +
+                                                          +
+                                                          +
+                                                          +
+                                                          +
+                                                          +
+                                                          +
+                                                          +
+                                                          +
+                                                          +
+                                                          +
+                                                          +
+                                                          +
+                                                          +
+                                                          +
+                                                          +
+                                                          +
+                                                          +
+                                                          +
+                                                          +
+                                                          +
+                                                          +
+                                                          +
+                                                          +
+                                                          +
+                                                          +
+                                                          +
+                                                          +
+                                                          +
+                                                          +
++++++++++++++++++++++++++++++++++++++++++++++++++++++++++++
