++++++++++++++++++++++++++++++
+0A                         a+
+                            +
+                            +
+                            +
+                            +
+                            +
+                            +
+                            +
+                            +
+                            +
+                            +
+                            +
+                            +
+                            +
+                            +
+                            +
+                            +
+                            +
+                            +
+                            +
+                            +
+                            +
+                            +
+                            +   
+                            +
+                            +
+                            +
+                            +
++++++++++++++++++++++++++++++
